++++++++++++++++++++++
+     ++    ++  ++  ++
+  +    +++     +   ++
+  +    ++ ++++  +  ++
+++  ++ +    +++   +
+    +    ++
+++++ +++ ++++++ +++++